34
9
10 10 10 10 10 10 10 10 10 10 10 10 10 10 10 10 10 10 10 10 10 10 10 10 10 10 10 10 10 10 10 10 10 10 
10 1 1 1 1 1 1 1 1 1 1 1 1 1 1 1 1 1 1 1 1 1 1 1 1 1 1 1 1 1 1 1 1 10 
10 1 10 10 10 1 1 1 10 10 10 1 1 1 10 10 10 1 1 1 10 10 1 10 10 1 1 1 10 1 10 10 1 10 
10 1 10 10 10 1 1 1 10 10 10 1 1 1 10 10 10 1 1 1 10 10 1 10 10 1 1 1 1 1 10 1 1 10 
10 1 1 1 1 1 1 1 1 1 1 1 1 1 1 1 1 1 1 1 1 1 1 1 1 1 1 1 10 1 10 1 1 10 
10 1 10 10 10 1 1 1 10 10 10 1 1 1 10 10 10 1 1 1 10 10 1 10 10 1 1 1 1 1 10 1 1 10 
10 1 10 10 10 1 1 1 10 10 10 1 1 1 10 10 10 1 1 1 10 10 1 10 10 1 1 1 10 1 10 1 1 10 
10 1 1 1 1 1 1 1 1 1 1 1 1 1 1 1 1 1 1 1 1 1 1 1 1 1 1 1 1 1 10 1 1 10 
10 10 10 10 10 10 10 10 10 10 10 10 10 10 10 10 10 10 10 10 10 10 10 10 10 10 10 10 10 10 10 10 10 10 
